1111111111
1100000001
100E1C1001
10C1000001
1100C00011
1000010001
101001C001
1C0010C0C1
1C000CCP01
1111111111