1111111111111111111111111111111111
1E00000000000000100000000000000001
100000000000000010000000000P000001
1000000000000000100000000000000001
1000000000000000000000000000000001
1000000111111111100000000000000001
1000000100000000100000000000000001
1000000100000000100000000000000001
1000000000000000100000000000000001
1111101000000001100000000000000001
1000001000000000100000000000000001
1000001000000000100000000000000001
10000010000000001000000000000000C1
1111111111111111111111111111111111
