11111111111111111111
1E00C0010000000C10C1
10000000000000001001
1111111100P000001001
1CCCCC0CC00000000001
1C000001111111111101
11111101C00000001001
10000001C00011101001
1CCCCCCCC000100010C1
11111111111111111111
